kommunenummer,kommunenavn,Divorced,Married,Not married,Other matrimonial status,Separated,Widow(er),Total
5018,Åfjord ,242,1192,1647,0,27,232,3340
5016,Agdenes ,133,640,776,0,15,129,1693
619,Ål ,394,1643,2320,0,24,290,4671
1504,Ålesund ,3275,16245,26063,11,480,1924,47998
1820,Alstahaug,544,2462,3973,1,69,366,7415
2012,Alta ,1649,6035,11990,8,266,717,20665
438,Alvdal ,158,796,1312,0,28,124,2418
929,Åmli ,153,649,901,0,35,110,1848
429,Åmot ,398,1279,2424,3,46,257,4407
1871,Andøy,397,1711,2283,2,48,330,4771
1424,Årdal ,338,1827,2658,0,40,382,5245
118,Aremark ,129,537,579,2,22,88,1357
906,Arendal ,4367,15972,21745,14,623,2064,44785
214,Ås ,1381,6996,11091,14,213,640,20335
1026,Åseral ,54,350,468,0,5,62,939
220,Asker ,4613,23673,30271,31,729,2206,61523
124,Askim ,1734,5517,7617,8,230,759,15865
1247,Askøy ,1794,10217,16028,4,291,941,29275
1428,Askvoll ,183,1168,1462,0,16,209,3038
425,Åsnes ,803,2337,3488,7,89,490,7214
1027,Audnedal ,86,756,829,0,22,87,1780
1547,Aukra,238,1356,1750,0,33,162,3539
1576,Aure,250,1271,1778,0,29,225,3553
1421,Aurland ,95,579,966,1,12,111,1764
221,Aurskog-Høland ,1556,5858,8031,10,221,824,16500
1244,Austevoll ,247,2016,2658,1,60,230,5212
1264,Austrheim ,201,1094,1404,0,39,149,2887
1554,Averøy,452,2165,2874,1,59,298,5849
219,Bærum ,9442,48014,62968,61,1444,4912,126841
1418,Balestrand ,90,485,635,0,7,62,1279
1854,Ballangen ,186,835,1260,2,29,158,2470
1933,Balsfjord ,482,1728,3011,1,42,361,5625
814,Bamble ,1229,5510,6494,1,154,701,14089
1922,Bardu ,233,1262,2303,2,38,192,4030
2028,Båtsfjord ,161,699,1290,1,30,89,2270
1839,Beiarn,80,367,498,0,7,70,1022
1929,Berg ,74,295,447,1,7,64,888
1201,Bergen ,20741,88488,158330,135,2973,10523,281190
2024,Berlevåg ,124,290,502,0,6,59,981
1811,Bindal,101,475,756,0,8,110,1450
928,Birkenes ,332,1997,2622,2,61,198,5212
1114,Bjerkreim,134,1236,1315,0,29,93,2807
5017,Bjugn ,442,1583,2575,0,46,258,4904
1867,Bø (Nordland),263,846,1277,0,25,205,2616
821,Bø (Telemark) ,422,1978,3845,8,82,295,6630
1804,Bodø,3780,16021,29832,16,511,1864,52024
1145,Bokn,50,329,400,0,8,53,840
1219,Bømlo ,660,4705,5943,1,94,557,11960
1438,Bremanger ,192,1408,1795,0,33,277,3705
1813,Brønnøy,636,2339,4473,1,90,377,7916
938,Bygland ,86,449,581,0,18,58,1192
941,Bykle ,63,338,511,0,10,31,953
2025,Deatnu - Tana ,266,828,1595,3,48,160,2900
1850,Divtasvuodna - Tysfjord ,159,624,1001,1,16,124,1925
1827,Dønna,105,492,693,0,18,83,1391
511,Dovre ,271,846,1294,2,29,173,2615
602,Drammen ,6727,23665,34384,32,931,3194,68933
817,Drangedal ,369,1439,1979,5,34,254,4080
1926,Dyrøy ,97,363,567,0,12,90,1129
1443,Eid ,366,2078,3343,1,62,301,6151
1551,Eide ,250,1200,1786,0,31,166,3433
1232,Eidfjord ,68,314,456,0,9,59,906
125,Eidsberg ,1118,4027,5488,1,176,614,11424
420,Eidskog ,736,1974,2858,2,90,454,6114
237,Eidsvoll ,2277,8458,12821,17,334,1012,24919
1101,Eigersund,1003,5925,7042,2,173,685,14830
427,Elverum ,1920,6606,11297,5,247,1116,21191
229,Enebakk ,867,4005,5624,3,166,361,11026
434,Engerdal ,114,430,635,5,6,96,1286
1211,Etne ,196,1636,2001,0,37,207,4077
541,Etnedal ,119,415,662,0,21,88,1305
1853,Evenes,134,506,632,0,17,98,1387
937,Evje og Hornnes ,321,1281,1784,0,47,205,3638
729,Færder ,2746,9973,12275,7,332,1367,26700
1003,Farsund ,703,3842,4499,0,126,525,9695
1841,Fauske - Fuosko,802,3103,5238,2,112,503,9760
1265,Fedje ,44,242,234,0,0,42,562
227,Fet ,895,4561,5822,4,136,424,11842
1141,Finnøy ,146,1413,1432,0,17,142,3150
1222,Fitjar ,190,1277,1584,0,21,129,3201
1429,Fjaler ,142,899,1543,0,17,169,2770
1246,Fjell ,1687,9393,13955,7,311,813,26166
615,Flå ,98,313,553,0,10,78,1052
1859,Flakstad,87,456,642,0,10,97,1292
5049,Flatanger,74,421,547,0,8,53,1103
1004,Flekkefjord ,647,3547,4251,0,124,497,9066
631,Flesberg ,200,957,1354,2,36,145,2694
1401,Flora ,786,3949,6470,1,103,543,11852
439,Folldal ,130,571,738,2,16,120,1577
1432,Førde ,806,3932,7810,0,124,420,13092
1129,Forsand ,77,488,555,0,17,56,1193
5048,Fosnes ,66,236,248,0,6,49,605
1548,Fræna ,745,3374,5152,1,105,423,9800
106,Fredrikstad ,7860,29115,39737,25,1134,3901,81772
215,Frogn ,1642,5849,7384,9,197,680,15761
919,Froland ,443,2150,2932,1,89,230,5845
5036,Frosta,160,978,1320,2,26,146,2632
5014,Frøya,339,1722,2708,0,54,245,5068
1241,Fusa ,209,1559,1838,1,32,222,3861
831,Fyresdal ,95,412,687,0,13,79,1286
1940,Gáivuotna - Kåfjord - Kaivuono ,169,676,1085,0,23,144,2097
2023,Gamvik ,122,323,646,0,12,66,1169
1430,Gaular ,144,1086,1632,2,25,138,3027
522,Gausdal ,489,2085,3134,3,52,349,6112
1838,Gildeskål,174,697,937,0,28,142,1978
1532,Giske,451,3125,4422,1,76,323,8398
1557,Gjemnes,180,999,1306,0,18,138,2641
234,Gjerdrum ,533,2603,3373,4,70,240,6823
911,Gjerstad ,235,883,1146,0,39,151,2454
1122,Gjesdal,684,4534,6195,7,136,343,11899
502,Gjøvik ,2645,9972,16120,7,362,1570,30676
1445,Gloppen ,301,2193,2989,0,41,312,5836
617,Gol ,419,1533,2326,1,53,244,4576
534,Gran ,1221,4647,6739,9,199,827,13642
1825,Grane,122,527,744,0,14,86,1493
1234,Granvin ,59,336,470,0,10,62,937
1919,Gratangen ,102,336,586,0,13,68,1105
904,Grimstad ,1833,8581,11650,13,253,916,23246
5045,Grong,187,802,1202,0,28,155,2374
423,Grue ,547,1557,2101,2,75,364,4646
1411,Gulen ,143,858,1156,0,22,143,2322
2011,Guovdageaidnu - Kautokeino ,116,766,1868,0,30,144,2924
1119,Hå,1141,7571,9260,2,219,621,18814
1866,Hadsel,713,2604,4277,2,66,429,8091
1034,Hægebostad ,66,732,766,1,20,98,1683
101,Halden ,3060,10794,15258,20,495,1550,31177
1571,Halsa ,112,582,762,0,13,105,1574
403,Hamar ,3033,10301,15779,14,360,1657,31144
1849,Hamarøy - Hábmer ,181,565,861,0,13,127,1747
2004,Hammerfest ,784,3021,6243,1,94,393,10536
1534,Haram ,547,3667,4600,1,94,474,9383
1517,Hareid,333,1817,2675,1,65,264,5155
1903,Harstad - Hárstták ,1961,8135,13290,8,244,1189,24827
2015,Hasvik ,89,305,574,0,11,66,1045
1826,Hattfjelldal,76,482,710,0,15,76,1359
1106,Haugesund,3291,12664,19155,17,504,1619,37250
5011,Hemne ,334,1415,2202,1,31,245,4228
1832,Hemnes,337,1388,2433,0,57,286,4501
618,Hemsedal ,169,823,1379,0,27,83,2481
1515,Herøy (Møre og Romsdal),543,3420,4437,0,66,461,8927
1818,Herøy (Nordland),122,564,970,0,17,107,1780
5013,Hitra ,379,1580,2436,0,52,247,4694
827,Hjartdal ,88,578,796,0,10,100,1572
1133,Hjelmeland,145,1140,1239,0,19,141,2684
138,Hobøl ,480,2066,2834,0,65,197,5642
620,Hol ,374,1570,2226,1,53,249,4473
612,Hole ,565,2567,3336,8,89,280,6845
715,Holmestrand ,1481,5204,6836,4,175,671,14371
5026,Holtålen,137,689,1061,0,17,121,2025
1444,Hornindal ,47,424,611,0,7,63,1152
701,Horten ,2866,9666,13038,15,371,1378,27334
1416,Høyanger ,337,1352,2109,0,44,249,4091
5046,Høylandet,60,491,616,0,10,77,1254
239,Hurdal ,315,928,1441,1,22,157,2864
628,Hurum ,995,3608,4344,7,103,464,9521
111,Hvaler ,508,1961,1866,2,48,214,4599
1413,Hyllestad ,88,522,650,0,14,92,1366
1917,Ibestad ,115,456,650,0,11,143,1375
5053,Inderøy,467,2468,3432,0,83,354,6804
5054,Indre Fosen,720,3564,5009,0,105,590,9988
935,Iveland ,102,543,609,0,22,50,1326
532,Jevnaker ,710,2284,3397,4,92,359,6846
1431,Jølster ,149,1081,1658,0,20,139,3047
1227,Jondal ,65,445,495,1,6,75,1087
2021,Kárásjohka - Karasjok ,216,680,1624,1,23,129,2673
1936,Karlsøy ,203,736,1123,0,34,156,2252
1149,Karmøy,2734,16345,20768,5,454,1855,42161
5030,Klæbu ,388,2018,3453,3,62,152,6076
1120,Klepp,1207,7522,9823,7,226,569,19354
604,Kongsberg ,2364,9712,13901,11,358,1135,27481
402,Kongsvinger ,2098,5891,8523,6,217,1088,17823
815,Kragerø ,1095,3739,4817,5,128,622,10406
1001,Kristiansand ,7272,32562,47709,20,1130,3589,92282
1505,Kristiansund,2041,8138,12591,11,302,1191,24274
622,Krødsherad ,224,724,1142,1,23,125,2239
1911,Kvæfjord ,255,951,1475,0,28,149,2858
1943,Kvænangen ,100,410,585,0,25,82,1202
2017,Kvalsund ,94,347,468,0,11,68,988
1238,Kvam ,477,3248,4140,0,81,495,8441
1037,Kvinesdal ,445,2243,2932,1,82,345,6048
1224,Kvinnherad ,978,4791,6512,1,106,749,13137
829,Kviteseid ,194,884,1159,2,29,135,2403
1144,Kvitsøy,32,246,206,0,6,26,516
1422,Lærdal ,142,732,1134,1,29,113,2151
712,Larvik ,4721,17226,22077,21,629,2433,47107
2022,Lebesby ,154,377,706,0,18,73,1328
1419,Leikanger ,121,835,1243,0,13,119,2331
1822,Leirfjord,151,763,1264,0,23,119,2320
5052,Leka,34,219,271,0,4,39,567
1931,Lenvik ,956,3487,6530,5,130,571,11679
512,Lesja ,156,699,1006,0,17,131,2009
5037,Levanger,1410,6802,10948,14,215,865,20254
626,Lier ,2214,9988,12815,9,318,1029,26373
5042,Lierne,83,455,729,0,9,110,1386
501,Lillehammer ,2331,9148,14820,12,320,1392,28023
926,Lillesand ,915,4235,5227,3,128,482,10990
1263,Lindås ,1108,5786,8147,0,162,609,15812
1029,Lindesnes ,372,1997,2286,1,49,248,4953
1920,Loabák - Lavangen ,69,352,543,1,12,65,1042
1851,Lødingen,210,764,935,1,24,143,2077
514,Lom ,131,804,1174,2,28,154,2293
2014,Loppa ,86,314,433,0,9,75,917
230,Lørenskog ,3352,14719,20074,11,538,1412,40106
415,Løten ,703,2489,3968,3,102,398,7663
1112,Lund,197,1283,1547,1,35,150,3213
533,Lunner ,827,3236,4471,4,114,399,9051
1834,Lurøy,131,677,956,0,16,124,1904
1426,Luster ,280,1787,2811,0,44,273,5195
1032,Lyngdal ,577,3424,4101,0,106,401,8609
1938,Lyngen ,224,975,1430,0,16,202,2847
1924,Målselv ,483,2167,3785,1,51,318,6805
5031,Malvik,897,4828,7789,4,135,387,14040
1002,Mandal ,1419,5878,7416,6,190,750,15659
119,Marker ,324,1426,1565,1,60,216,3592
1021,Marnardal ,163,904,1097,0,35,98,2297
1266,Masfjorden ,100,663,814,0,12,122,1711
2018,Måsøy ,109,379,645,0,15,87,1235
1256,Meland ,471,3093,4293,4,73,253,8187
5023,Meldal ,279,1391,1978,0,46,211,3905
5028,Melhus,1106,5649,8952,2,187,666,16562
1837,Meløy,490,2166,3265,1,55,354,6331
5034,Meråker,194,822,1237,2,25,152,2432
1545,Midsund ,138,768,983,0,9,121,2019
5027,Midtre Gauldal,402,2174,3265,3,55,347,6246
1252,Modalen ,32,118,206,2,1,21,380
623,Modum ,1409,4751,6843,10,203,764,13980
1502,Molde ,2205,9333,14048,0,259,1156,27001
1874,Moskenes,77,382,495,0,4,81,1039
104,Moss ,3702,11435,15491,18,452,1628,32726
5051,Nærøy ,340,1663,2742,2,42,283,5072
5040,Namdalseid ,151,549,767,0,14,95,1576
5005,Namsos ,1073,3970,7286,2,122,660,13113
5044,Namsskogan,76,305,421,0,12,57,871
238,Nannestad ,1179,4738,7163,9,158,435,13682
1805,Narvik ,1473,6353,9648,1,199,956,18630
1433,Naustdal ,160,964,1512,0,31,126,2793
625,Nedre Eiker ,2209,9126,12276,9,336,1007,24963
236,Nes (Akershus) ,1906,7718,11107,11,246,897,21885
616,Nes (Buskerud) ,281,1231,1561,0,37,205,3315
1828,Nesna,127,597,950,0,19,99,1792
216,Nesodden ,1759,6704,10144,30,255,596,19488
1543,Nesset ,153,1084,1493,0,26,200,2956
830,Nissedal ,121,539,708,0,23,85,1476
233,Nittedal ,1947,8453,12640,18,259,772,24089
819,Nome ,568,2219,3263,1,83,404,6538
542,Nord-Aurdal ,659,2091,3198,2,62,406,6418
1524,Norddal ,88,650,785,0,16,106,1645
516,Nord-Fron ,504,1828,2981,0,59,370,5742
2019,Nordkapp ,327,970,1700,0,45,176,3218
418,Nord-Odal ,485,1741,2399,0,56,343,5024
538,Nordre Land ,601,2072,3464,2,76,456,6671
1942,Nordreisa - Ráisa - Raisi ,440,1412,2727,0,55,275,4909
633,Nore og Uvdal ,179,880,1192,0,27,170,2448
807,Notodden ,1177,4215,6402,9,145,734,12682
1228,Odda ,540,2318,3312,2,74,499,6745
1868,Øksnes,365,1418,2358,1,33,274,4449
5021,Oppdal,516,2475,3537,1,83,363,6975
217,Oppegård ,2179,10676,13168,6,295,1070,27394
5024,Orkdal ,946,4002,6390,6,169,573,12086
5015,Ørland ,407,1767,2816,1,48,295,5334
1523,Ørskog ,155,888,1091,1,24,91,2250
1520,Ørsta,667,3834,5732,0,79,545,10857
441,Os (Hedmark) ,131,719,936,1,11,114,1912
1243,Os (Hordaland) ,1472,7333,11048,4,244,703,20804
5020,Osen,72,338,459,0,13,65,947
301,Oslo municipality,52848,195472,403064,1113,9042,19532,681071
1253,Osterøy ,508,2960,4238,2,72,340,8120
528,Østre Toten ,1360,5221,7334,12,151,870,14948
5047,Overhalla,200,1384,2068,0,38,189,3879
624,Øvre Eiker ,1692,6634,9731,2,225,833,19117
521,Øyer ,387,1825,2584,0,39,284,5119
1259,Øygarden ,309,1783,2506,0,80,211,4889
544,Øystre Slidre ,239,1042,1684,7,52,184,3208
2020,Porsanger - Porsángu - Porsanki ,426,1134,2140,0,49,195,3944
805,Porsgrunn ,3667,12398,17820,6,459,1874,36224
5043,Raarvihke - Røyrvik,30,178,240,0,2,32,482
135,Råde ,599,3131,3316,0,100,396,7542
1260,Radøy ,312,1967,2532,2,56,222,5091
228,Rælingen ,1497,6288,9562,6,244,564,18161
128,Rakkestad ,663,3067,3913,7,107,473,8230
1833,Rana,2028,8638,14025,6,252,1366,26315
1127,Randaberg,625,4458,5526,3,80,361,11053
1539,Rauma,552,2607,3826,0,70,432,7487
716,Re ,779,3591,4890,5,90,375,9730
432,Rendalen ,171,634,816,0,29,141,1791
5022,Rennebu,177,925,1233,0,24,142,2501
1142,Rennesøy ,240,1940,2478,3,37,149,4847
5061,Rindal,84,764,1033,0,33,114,2028
520,Ringebu ,330,1534,2236,0,47,278,4425
605,Ringerike ,3054,10172,15224,18,394,1580,30442
412,Ringsaker ,2841,11585,17782,13,456,1811,34488
901,Risør ,702,2505,3127,0,82,432,6848
5019,Roan ,60,352,468,0,3,74,957
1836,Rødøy,85,402,660,0,7,84,1238
632,Rollag ,117,540,661,2,8,91,1419
121,Rømskog ,56,303,263,0,4,47,673
5025,Røros,471,1763,3009,0,46,321,5610
1856,Røst,57,134,272,0,6,39,508
627,Røyken ,1863,8539,11203,7,247,776,22635
136,Rygge ,1563,6064,7560,10,191,757,16145
1923,Salangen ,168,708,1166,1,17,123,2183
1840,Saltdal,360,1600,2423,0,26,248,4657
1242,Samnanger ,144,980,1201,0,14,126,2465
1514,Sande (Møre og Romsdal),140,1008,1148,0,23,174,2493
713,Sande (Vestfold) ,849,3668,4833,1,123,430,9904
710,Sandefjord ,6473,22196,30822,38,845,2897,63271
1102,Sandnes ,5348,29109,39461,23,901,2404,77246
1546,Sandøy ,70,524,545,0,8,91,1238
105,Sarpsborg ,5552,19859,26988,10,786,2802,55997
1135,Sauda,283,1737,2227,0,47,303,4597
822,Sauherad ,354,1591,2080,0,45,223,4293
517,Sel ,437,1923,2976,2,81,370,5789
5032,Selbu,239,1371,2198,0,30,250,4088
1441,Selje ,146,1093,1295,0,28,185,2747
828,Seljord ,222,1027,1473,0,41,171,2934
621,Sigdal ,355,1166,1688,0,45,236,3490
811,Siljan ,181,941,1063,2,22,120,2329
1046,Sirdal ,119,679,933,0,19,89,1839
1913,Skånland ,227,1102,1466,1,29,184,3009
5029,Skaun,554,2671,4651,3,71,281,8231
231,Skedsmo ,4806,19531,28287,28,751,2249,55652
213,Ski ,2410,11248,15627,19,380,1159,30843
806,Skien ,5383,18921,26868,23,756,2694,54645
127,Skiptvet ,328,1358,1883,3,44,181,3797
513,Skjåk ,159,756,1100,0,36,153,2204
1941,Skjervøy ,221,1046,1440,0,49,161,2917
1529,Skodje ,318,1683,2568,0,28,167,4764
1573,Smøla,151,785,1042,1,20,135,2134
5041,Snåase - Snåsa,152,728,1083,2,13,122,2100
5012,Snillfjord ,58,357,517,0,11,56,999
1420,Sogndal ,377,2521,4884,0,51,358,8191
1018,Søgne ,912,4383,5477,3,155,473,11403
1111,Sokndal,240,1331,1509,0,36,189,3305
1124,Sola,1626,10330,13546,3,275,802,26582
1412,Solund ,40,328,385,0,8,59,820
1812,Sømna,172,612,1060,0,30,140,2014
536,Søndre Land ,546,1805,2854,5,68,345,5623
1017,Songdalen ,520,2411,3403,0,100,272,6706
540,Sør-Aurdal ,240,1126,1359,2,47,207,2981
1845,Sørfold,158,649,1012,0,17,139,1975
519,Sør-Fron ,217,1087,1615,0,39,169,3127
419,Sør-Odal ,780,2657,3880,3,109,450,7879
1925,Sørreisa ,268,1158,1863,0,33,167,3489
1870,Sortland - Suortá,893,3149,5860,8,119,489,10518
226,Sørum ,1416,6575,9451,8,228,585,18263
2030,Sør-Varanger ,828,3125,5621,2,114,466,10156
123,Spydeberg ,499,2211,2966,1,68,297,6042
417,Stange ,1763,7215,10693,11,202,1032,20916
1103,Stavanger,9671,46859,71143,55,1587,4722,134037
1848,Steigen,215,914,1262,0,24,161,2576
5004,Steinkjer ,1747,7358,11574,6,230,1175,22090
5035,Stjørdal,1788,8108,12848,10,235,1039,24028
1221,Stord ,1128,6968,9673,6,183,741,18699
1526,Stordal ,65,329,482,0,8,63,947
430,Stor-Elvdal ,276,808,1151,3,48,173,2459
1939,Storfjord - Omasvuotna - Omasvuono ,186,572,950,0,22,111,1841
1130,Strand,782,4936,6361,3,128,510,12720
1525,Stranda,227,1807,2231,0,49,251,4565
1449,Stryn ,410,2479,3876,2,47,353,7167
1531,Sula,501,3449,4876,2,78,365,9271
1134,Suldal,216,1544,1816,0,33,185,3794
1245,Sund ,435,2511,3769,2,84,261,7062
1563,Sunndal,521,2388,3666,3,93,435,7106
1566,Surnadal,404,2130,2995,0,49,350,5928
1216,Sveio ,320,2258,2857,2,52,232,5721
711,Svelvik ,722,2452,3108,2,76,325,6685
1528,Sykkylven,465,2842,3905,2,76,367,7657
1121,Time,1220,7256,9518,3,185,613,18795
1560,Tingvoll,210,1123,1480,0,32,200,3045
826,Tinn ,542,1982,2805,2,80,369,5780
1852,Tjeldsund ,111,519,537,0,9,83,1259
833,Tokke ,197,746,1116,0,25,144,2228
436,Tolga ,97,560,781,0,15,98,1551
704,Tønsberg ,4764,15589,22934,27,586,2076,45976
1928,Torsken ,91,295,461,0,11,73,931
1835,Træna,27,157,239,0,7,26,456
1927,Tranøy ,135,530,734,0,12,102,1513
122,Trøgstad ,536,1893,2541,3,73,301,5347
1902,Tromsø ,5507,21607,46471,52,741,2271,76649
5001,Trondheim,13981,57662,115995,88,1851,6582,196159
428,Trysil ,633,2143,3346,1,69,415,6607
914,Tvedestrand ,562,2256,2802,0,85,364,6069
5033,Tydal,50,288,392,0,7,57,794
437,Tynset ,393,1885,2941,1,56,315,5591
1223,Tysnes ,211,1082,1377,0,19,157,2846
1146,Tysvær,615,4357,5548,3,98,407,11028
235,Ullensaker ,3348,12707,20295,21,561,1302,38234
1231,Ullensvang ,200,1275,1578,2,29,236,3320
1516,Ulstein,568,3243,4387,0,82,329,8609
1233,Ulvik ,80,407,532,1,6,67,1093
2027,Unjárga - Nesseby ,99,244,528,1,20,49,941
1151,Utsira,12,91,83,1,1,8,196
2003,Vadsø ,484,1816,3256,3,65,270,5894
1857,Værøy,48,247,393,0,3,41,732
515,Vågå ,238,1169,1892,1,36,253,3589
1865,Vågan,773,3163,5103,7,104,445,9595
1439,Vågsøy ,333,2270,2944,0,49,374,5970
1251,Vaksdal ,284,1374,2068,0,36,283,4045
426,Våler (Hedmark) ,373,1253,1800,0,43,236,3705
137,Våler (Østfold) ,446,2123,2781,0,74,169,5593
940,Valle ,81,421,562,0,21,71,1156
545,Vang ,118,542,844,1,16,89,1610
1511,Vanylven,193,1280,1431,0,31,228,3163
2002,Vardø ,219,558,1156,0,19,129,2081
1824,Vefsn,1135,4125,7249,0,150,744,13403
1815,Vega,100,399,619,0,13,101,1232
912,Vegårshei ,140,818,988,0,30,117,2093
1014,Vennesla ,1107,5547,7160,0,204,612,14630
5038,Verdal,1089,4851,8112,2,136,743,14933
5039,Verran ,202,868,1181,0,34,164,2449
211,Vestby ,1566,6513,8923,0,238,584,17824
1535,Vestnes,464,2351,3341,1,65,314,6536
543,Vestre Slidre ,208,685,1091,2,21,128,2135
529,Vestre Toten ,1251,4470,6776,4,160,723,13384
1860,Vestvågøy,921,3425,6416,4,144,570,11480
1816,Vevelstad,35,151,276,0,5,30,497
1417,Vik ,149,987,1329,0,17,190,2672
5050,Vikna ,335,1370,2632,2,38,201,4578
1160,Vindafjord,422,3483,4339,0,73,426,8743
834,Vinje ,257,1251,1969,3,29,214,3723
1519,Volda ,520,3284,4873,2,111,407,9197
1235,Voss ,858,5049,7761,0,107,831,14606
